; [map size]
44 30
; [player spawn]
96 112
; [tiles]
0 17 17 17 17 17 17 17 17 17 17 17 17 17 17 17 16 21 21 21 21 21 21 21 21 21 21 21 18 17 17 3 2 3 0 12 20 13 13 13 13 13 13 14 
15 4 5 4 4 6 4 4 4 4 5 4 4 4 4 4 0 0 0 0 3 0 0 0 0 0 0 0 21 21 14 0 3 0 12 0 21 0 3 2 3 0 0 15 
15 6 4 4 4 4 4 4 7 4 4 4 4 5 7 4 3 0 0 0 0 0 0 0 0 0 0 2 0 12 13 13 13 13 0 2 3 0 0 0 0 0 3 15 
15 4 4 4 7 4 4 4 4 4 4 4 4 4 0 0 0 0 0 0 2 2 0 0 0 0 0 0 0 25 26 26 26 26 27 0 0 0 1 0 0 3 2 15 
15 7 4 4 6 4 5 4 6 4 4 4 6 4 0 0 0 2 0 0 2 0 0 1 35 39 39 39 39 39 39 39 39 39 39 39 39 39 39 41 0 0 0 15 
15 4 6 4 4 6 4 4 4 5 4 4 0 4 0 0 3 0 0 0 0 0 0 0 0 0 0 0 0 19 0 1 0 0 0 0 0 0 0 38 0 3 3 15 
15 5 4 4 4 4 7 4 4 4 4 0 0 0 0 0 0 0 0 0 0 0 0 0 0 0 3 3 20 19 0 0 3 0 2 0 0 0 0 38 0 3 0 15 
15 4 7 4 4 5 4 6 4 7 0 0 0 0 0 0 0 0 0 0 3 0 0 0 0 0 0 0 21 18 17 0 0 0 0 0 3 0 3 38 0 2 0 15 
15 4 6 6 4 4 4 4 4 0 0 0 2 25 26 26 30 26 26 26 27 0 0 0 0 0 0 0 0 23 23 18 17 17 17 0 1 0 0 38 0 0 3 15 
15 4 4 4 4 0 0 0 3 35 39 39 41 3 0 0 0 0 3 0 32 0 0 0 0 0 0 0 0 21 20 22 23 22 22 18 17 17 17 38 20 17 17 16 
15 0 0 0 0 0 0 0 0 2 3 0 38 0 0 0 0 0 0 0 28 3 0 1 1 1 1 0 0 3 22 21 21 21 21 23 22 23 21 38 21 22 22 23 
15 0 0 3 0 13 14 0 0 20 0 0 38 0 3 0 32 25 26 26 29 0 0 0 0 0 0 0 0 0 21 0 0 1 3 21 21 21 0 38 0 21 21 21 
15 3 0 0 0 2 15 0 0 22 0 0 38 0 0 0 1 2 0 0 0 0 0 0 0 0 0 12 13 14 3 0 0 0 0 12 13 14 0 38 0 0 0 15 
15 0 17 0 1 0 15 0 0 21 0 3 38 3 0 0 0 0 0 0 2 0 0 0 0 0 12 18 17 16 0 0 0 0 0 19 2 16 0 38 0 3 0 15 
15 0 21 18 17 17 16 0 35 39 39 39 48 39 39 39 39 39 39 39 39 39 39 39 39 41 18 22 23 22 26 26 30 27 0 18 16 21 1 38 0 0 0 15 
15 0 1 21 21 21 21 0 0 0 0 0 38 2 0 0 0 3 0 0 0 0 0 0 0 38 21 21 21 21 3 1 3 32 0 21 21 0 0 38 0 0 0 15 
15 0 3 0 0 0 2 0 3 0 0 0 38 0 0 0 0 0 0 0 17 17 17 17 3 38 3 33 3 2 0 3 3 28 0 0 0 0 0 38 0 0 0 15 
15 3 0 0 0 3 0 1 0 0 0 0 38 0 0 3 2 0 3 16 24 24 24 24 19 47 39 34 3 0 3 2 3 32 0 0 0 0 0 38 0 3 0 15 
16 2 0 1 0 0 0 0 0 0 0 0 38 3 0 0 0 1 15 24 20 24 24 24 19 38 0 25 26 30 26 26 26 29 0 0 3 0 0 38 0 0 3 15 
22 19 0 0 0 0 0 0 1 0 0 0 38 0 0 0 0 3 15 24 24 24 24 12 0 38 0 0 0 0 0 0 0 0 0 0 3 0 0 38 0 0 0 15 
23 19 0 3 0 2 0 1 0 0 0 0 38 3 0 0 0 0 0 14 24 24 24 19 0 38 0 0 0 3 0 0 0 0 0 0 2 0 0 38 0 3 0 15 
24 19 0 0 0 0 0 0 0 3 0 0 38 0 0 0 0 0 0 3 13 13 13 0 0 38 0 1 0 0 0 0 0 0 1 3 2 0 0 38 0 0 0 15 
24 18 17 0 0 0 0 0 0 0 1 3 38 2 1 2 1 0 0 0 25 26 26 27 0 38 0 0 0 2 0 0 0 0 0 0 0 0 0 38 0 0 0 15 
24 22 22 18 0 0 0 0 0 0 0 0 47 39 39 39 39 39 39 39 39 39 39 39 39 44 39 39 39 39 39 39 39 39 39 39 39 39 39 42 3 0 0 15 
24 24 24 20 18 17 17 0 0 0 0 0 38 2 0 0 0 0 1 0 0 0 0 0 0 0 0 0 0 0 0 0 0 3 0 0 0 0 0 0 0 0 0 15 
24 24 24 24 24 24 24 18 0 0 0 0 36 0 0 0 0 0 0 0 0 0 0 0 0 0 2 0 0 0 0 0 0 0 0 0 0 0 0 1 0 0 0 15 
24 24 20 24 24 24 24 24 18 17 0 0 2 0 0 0 0 0 0 0 0 0 0 0 0 0 0 0 0 0 0 0 1 0 0 0 3 0 0 0 0 0 3 15 
24 24 24 24 24 24 24 24 24 24 18 17 17 0 0 0 1 0 0 0 0 0 2 0 0 0 0 0 2 0 0 3 0 0 0 3 0 0 0 0 0 0 0 15 
24 24 24 24 24 24 24 24 20 24 24 24 24 18 0 0 0 0 0 0 0 0 0 0 0 0 0 0 0 0 0 0 0 0 0 0 0 0 0 3 0 0 0 15 
24 24 24 24 24 24 24 24 24 24 24 24 24 24 18 17 17 17 17 17 17 17 17 17 17 17 17 17 17 17 17 17 17 17 17 17 17 17 17 17 17 17 17 16 
; [entities]
13 1 dead_tree ;
18 1 tree ;
23 1 tree ;
12 2 rock ;
6 2 rock ;
4 2 dead_tree ;
1 3 rock ;
5 3 dead_tree ;
9 3 dead_tree ;
7 3 dead_tree ;
11 3 dead_tree ;
19 4 tree ;
3 5 rock ;
11 5 rock ;
37 5 tree ;
7 6 rock ;
15 6 tree ;
33 6 tree ;
37 6 tree ;
8 7 dead_tree ;
1 7 dead_tree ;
22 7 tree ;
18 7 tree ;
4 8 dead_tree ;
27 8 tree ;
6 9 rock ;
13 11 tree ;
33 11 tree ;
13 12 tree ;
11 12 tree ;
22 12 tree ;
7 15 tree ;
19 15 tree ;
15 15 tree ;
2 15 dead_tree ;
40 15 tree ;
11 16 tree ;
10 19 tree ;
24 20 tree ;
31 20 tree ;
15 21 tree ;
4 21 tree ;
2 21 tree ;
32 22 tree ;
8 24 tree ;
28 25 tree ;
18 26 tree ;
; [items]
